R 1280 1024
NO ./rcs/windowblue.xpm
SO ./rcs/windowred.xpm
WE ./rcs/windowyellow.xpm
EA ./rcs/windowgreen.xpm

S ./rcs/ball.xpm
F 25,42,41
C 110,140,180

1111111111111111111111111
1000000000000000000000001
1000000000000000000000001
1000000000000000000000001
1000111111100000000000001
1000100000100000000000001
1000100000100000000111001
1000111111100000000000001
1000000000000000000000001
1000000000000000000000001
1000000200000000000200001
1000000000000000000000001
1000000000000000000000001
1000011100000000000000001
1000011100000S00000000001
1000000000000000000000001
1000000000000000000000001
1000000000000000000000001
1000000000000000000000001
1111111111111111111111111
