R 1280 1024
NO ./rcs/windowblue.xpm
SO ./rcs/windowred.xpm
WE ./rcs/windowyellow.xpm
EA ./rcs/windowgreen.xpm

S ./rcs/ball.xpm
F 25,42,41
C 110,140,180

11111111111
10000000001
10100000001
10100000001
11000201011
10000000001
10200N00001
10000000011
11111111111
