R 800 600
NO ./img/text_N.xpm
SO ./img/text_S.xpm
WE ./img/text_W.xpm
EA ./img/text_E.xpm

S ./path_to_the_sprite_texture
F 220,100,0
C 225,30,0

11111111111
10000000001
1N110000001
10110000011
10001000001
10000000011
10100000001
10011000011
11111111111