R 1280 1024
NO ./rcs/greywall1.xpm
SO ./rcs/greywall2.xpm
WE ./rcs/greywall3.xpm
EA ./rcs/greywall4.xpm

S ./path_to_the_sprite_texture
F 100,140,255
C 100,150,230

11111111111
10000000001
10101101001
10100001001
10100101001
10000000001
1000N000001
10000000011
11111111111