R 1280 1024
NO ./img/text_N.xpm
SO ./img/text_S.xpm
WE ./img/text_W.xpm
EA ./img/text_E.xpm

S ./path_to_the_sprite_texture
F 220,100,0
C 225,30,0

11111111111
10000000001
10000000001
10100001001
10010010001
10001100001
10000000001
10000N00011
11111111111