R 1280 1024
NO ./rcs/windowblue.xpm
SO ./rcs/windowred.xpm
WE ./rcs/windowyellow.xpm
EA ./rcs/windowgreen.xpm

S ./rcs/cylindre.xpm
F 25,42,41
C 110,140,180

11111111111
10000000001
10101101001
10100001001
11111001111
10000000001
10000N00001
10000000011
11111111111
